# generated: 2025-12-20 11:13:23
# format: SYMBOL<TAB>reason
AAVEUSDC	no MARKET type
ADABTC	no MARKET type
ADAUSDC	no MARKET type
ALGOUSDC	no MARKET type
APEUSDC	no MARKET type
ATOMUSDC	no MARKET type
AVAXUSDC	no MARKET type
AZEROUSDC	no MARKET type
BCHUSDC	no MARKET type
BNBUSDC	no MARKET type
CAWUSDC	no MARKET type
CLVUSDT	st=true
DOGEUSDC	no MARKET type
ELFUSDT	st=true
ENSUSDC	no MARKET type
ETHUSDC	no MARKET type
EXSUSDT	st=true
FILUSDC	no MARKET type
FTNUSDT	st=true
FTTUSDC	no MARKET type
GRANDUSDT	status!=1
HELIUSDT	st=true
IMGNAIUSDT	status!=1
IXSUSDT	no MARKET type
JASMYUSDC	no MARKET type
KAIAUSDC	no MARKET type
KOMUSDT	st=true
LAK3USDT	st=true
LITUSDT	status!=1
LTCBTC	no MARKET type
LTCUSDC	no MARKET type
LUNCUSDC	no MARKET type
MINAUSDC	no MARKET type
MINUSDT	no MARKET type
MRLNUSDT	st=true
MXUSDC	no MARKET type
NEARUSDC	no MARKET type
NOVAUSDT	status!=1
OPUSDC	no MARKET type
PAXGUSDC	no MARKET type
PENUSDT	st=true
PIGGYUSDT	status!=1
RAYUSDC	no MARKET type
SHIBUSDC	no MARKET type
SLFUSDT	st=true
SOLUSDC	no MARKET type
SPLDUSDT	status!=1
TOMIUSDT	st=true
TRISIGUSDT	st=true
TROWUSDT	st=true
TRXUSDC	no MARKET type
UNIUSDC	no MARKET type
UTUSDT	st=true
WAVESUSDC	no MARKET type
WBTCUSDC	no MARKET type
XCVUSDT	st=true
XENUSDC	no MARKET type
XRPUSDC	no MARKET type
XYOUSDT	no MARKET type
